########################################
########################################
#                               ########
################# ######################
################# ######################
################# ######################
################# ######################
################# ######################
################# ######################
################# ######################
################# ######################
################# ######################
################# ######################
################# ######################
################# ######################
################# ######################
################# ######################
################# ######################
################# ######################
########################################

